11111111
1P00C001
1c0N00E1
11110111