11111111
1P000001
100N00E1
11111111