11111111111
1P1C0000011
10101111001
10100010011
10000CE0111
11111111111
