11111111
1P000C01
100E0001
11111111
