111111111111
1P0000000001
100100C00001
100000E000C1
100000011001
1C0010000CN1
111111111111
